------------------------근육통---------------------------

리렉스 : 근골격계 질환에 수반하는 동통(통증)성 연축(수축과 이완): 요배통증(허리, 등 통증), 경견완증후군(목, 어깨, 팔 증후군), 견관절(어깨관절)주위염, 변형성 척추증

셀라펜정 : 신경통, 근육통, 관절통, 요통, 염좌통, 견통, 근경련, 근경직등 근육의 이상 긴장을 수반하는 제질환

안티푸라민 파스 : 퇴행성 관절염(골관절염), 어깨관절주위염, 건(힘줄염).건초염(힘줄윤활막염), 건(힘줄)주위염, 상완골(위팔뼈)상과염(테니스 엘보우 등), 근육통, 외상후의 종창(부기).동통(통증)

-------------------------두통-----------------------------

게보린 : - 두통, 치통, 발치(이를 뽑음)후 동통(통증), 인후(목구멍)통, 귀의 통증, 관절통, 신경통, 요(허리)통, 근육통, 견통(어깨통증), 타박통, 골절통, 염좌통(삔 통증), 월경통(생리통), 외상(상처)통의 진통
- 오한(춥고 떨리는 증상), 발열시의 해열

이디아 : 긴장성 두통 및 혈관성 두통 (편두통)

타이레놀 : 감기로 인한 발열 및 동통(통증), 두통, 신경통, 근육통, 월경통, 염좌통(삔 통증)

-------------------------목적통-----------------------------

누니환 : 눈꺼풀 짓무름, 눈곱이 많이 끼고, 바람을 쐬면 눈물이 흐르고, 물체가 밝고 명확하게 보이지 않는 증상

마로이신 : 발적(충혈되어 붉어짐), 부기, 단단해지고 통증을 수반하는 화농성질환

프론크논 : 염증, 눈다래끼

-------------------------몸살감기-----------------------------

콜그린 : 감기의 제증상(콧물, 코막힘, 재채기, 인후통, 기침, 가래, 오한, 발열, 두통, 관절통, 근육통)의 완화

화이투벤 : 기침감기, 목감기, 초기감기

화콜 : 기침, 몸살, 감기

-------------------------복통-----------------------------

까스활명수 : 식욕감퇴(식욕부진), 위부팽만감, 소화불량, 과식, 식체(위체), 구역

베나치오 : 식욕감퇴(식욕부진), 위부팽만감, 소화불량, 과식, 체함, 구역, 구토

부스코판 : 위·십이지장궤양, 식도경련, 유문연축, 위염, 장염, 장산통, 경련성 변비, 기능성 설사, 담낭염, 담관염, 담석증, 담도이상운동증, 위·담낭절제후의 후유증, 요로결석, 방광염, 기능성설사, 기구삽입에 의한 요도·방광 경련, 월경곤란, 분만시 자궁하부경련

-------------------------비염-----------------------------

코싹 : 코막힘, 재채기, 콧물, 눈ㆍ코의 소양증

코앤쿨 : 코감기, 비염

코캅스 : 코감기, 알레르기성 및 혈관운동성 비염에 의한 다음 증상의 완화 : 재채기, 콧물, 코막힘, 눈물

-------------------------찰과상-----------------------------

마데카솔 : 네오마이신 감수성 세균에 의해 2차 감염된 코르티코이드 반응성 피부질환의 초기 치료 : 피부염, 감염된 상처

포비돈 : 수술자의 손 및 팔의 살균소독

후시딘 : 농피증(농가진, 감염성습진양피부염, 심상성여드름(보통여드름), 모낭염, 종기 및 종기증, 화농성한선염, 농가진성습진), 화상˙외상˙봉합창˙식피창에 의한 2차 감염

-------------------------치통-----------------------------

애드빌 : 두통, 치통, 발열및 통증

다펜큐 : 진통, 해열제

탁센 : 편두통, 치통, 관절염